# E # # # # # # # # # # # # #
# _ _ _ _ _ _ _ _ _ _ _ _ _ #
# _ _ _ # _ _ _ _ _ _ _ _ _ #
# _ _ _ # _ _ _ _ _ # # _ _ #
# _ _ _ _ _ _ _ _ _ _ # _ _ #
# _ _ _ _ _ _ # _ _ _ _ _ _ #
# _ _ _ _ _ _ _ _ _ _ _ _ _ #
# _ _ _ _ _ _ # _ _ _ _ _ _ #
# _ _ _ _ _ _ _ _ _ _ _ _ _ #
# _ _ _ _ _ _ # _ _ # # _ _ #
# _ _ _ _ _ _ _ _ _ _ _ _ _ #
# _ _ _ _ _ _ # _ _ _ _ # _ #
# _ _ _ _ _ _ # _ _ _ _ _ _ #
# _ _ _ _ _ _ _ _ _ _ _ _ _ #
# # # # # # # # # # # # # # #
1 1
5 5